Graph Size: 10
MAZE:
+ +-+-+-+-+-+-+-+-+-+
|     |       |     |
+-+-+ + +-+-+ +-+-+ +
|     |   | | |   | |
+ +-+-+ + + + + + + +
|   |   | | |   | | |
+-+ +-+-+ + +-+-+ + +
| |   |   |     |   |
+ +-+ + +-+ + +-+-+ +
|   |   | | |   |   |
+ + +-+-+ + +-+ + +-+
| | |       | | | | |
+ + + +-+-+-+ + + + +
| | | |       | | | |
+ +-+ + + +-+ + + + +
|   | | | | | |   | |
+ + + + + + + +-+-+ +
| | | | | | | |     |
+ + + +-+ + + +-+ + +
| |       |       | |
+-+-+-+-+-+-+-+-+-+ +

BFS:
+ +-+-+-+-+-+-+-+-+-+
|0 1 2|7 9 1 2|9 7 5|
+-+-+ + +-+-+ +-+-+ +
|5 4 3|6 5|1|3|6 7|3|
+ +-+-+ + + + + + + +
|6 7|0 8|4|9|4 5|8|1|
+-+ +-+-+ + +-+-+ + +
|2|8 9|2 3|8 6 7|9 0|
+ +-+ + +-+ + +-+-+ +
|8 3|0 1|4|0|5 4|4 2|
+ + +-+-+ + +-+ + +-+
|4|5|6 5 3 2|9|3|6| |
+ + + +-+-+-+ + + + +
|0|7|7|3 9 2 6|2|8| |
+ +-+ + + +-+ + + + +
|8 6|8|7|7|3|0|1 0|6|
+ + + + + + + +-+-+ +
|1|4|9|1|5|1|4|5 2 4|
+ + + +-+ + + +-+ + +
|5|2 0 1 3|9 6 8 0|7|
+-+-+-+-+-+-+-+-+-+ +

+ +-+-+-+-+-+-+-+-+-+
|# # #|# # # #|     |
+-+-+ + +-+-+ +-+-+ +
|# # #|# #| |#|# #| |
+ +-+-+ + + + + + + +
|# #|   |#| |# #|#| |
+-+ +-+-+ + +-+-+ + +
| |# #|# #|# #  |# #|
+ +-+ + +-+ + +-+-+ +
|   |# #| |#|# #|# #|
+ + +-+-+ + +-+ + +-+
| | |# # # #| |#|#| |
+ + + +-+-+-+ + + + +
| | |#|  # # #|#|#| |
+ +-+ + + +-+ + + + +
|   |#| |#| |#|# #| |
+ + + + + + + +-+-+ +
| | |#| |#| |#|  # #|
+ + + +-+ + + +-+ + +
| |  # # #|  # # #|#|
+-+-+-+-+-+-+-+-+-+ +
Path: (0,0) (0,1) (0,2) (1,2) (1,1) (1,0) (2,0) (2,1) (3,1) (3,2) (4,2) (4,3) (3,3) (3,4) (2,4) (1,4) (1,3) (0,3) (0,4) (0,5) (0,6) (1,6) (2,6) (2,7) (1,7) (1,8) (2,8) (3,8) (3,9) (4,9) (4,8) (5,8) (6,8) (7,8) (7,7) (6,7) (5,7) (4,7) (4,6) (3,6) (3,5) (4,5) (5,5) (5,4) (5,3) (5,2) (6,2) (7,2) (8,2) (9,2) (9,3) (9,4) (8,4) (7,4) (6,4) (6,5) (6,6) (7,6) (8,6) (9,6) (9,7) (9,8) (8,8) (8,9) (9,9) 
Length of path: 65
Visited cells: 98

DFS:
+ +-+-+-+-+-+-+-+-+-+
|0 1 2|7 8 9 0|3 2 1|
+-+-+ + +-+-+ +-+-+ +
|5 4 3|6 5|8|1|4 5|0|
+ +-+-+ + + + + + + +
|6 7|   |4|7|2 3|6|9|
+-+ +-+-+ + +-+-+ + +
| |8 9|2 3|6 4 5|7 8|
+ +-+ + +-+ + +-+-+ +
|   |0 1|2|9|3 2|5 4|
+ + +-+-+ + +-+ + +-+
| | |4 3 1 0|6|1|6|6|
+ + + +-+-+-+ + + + +
| | |5|  3 4 5|0|7|5|
+ +-+ + + +-+ + + + +
|   |6| |2| |7|9 8|4|
+ + + + + + + +-+-+ +
| | |7| |1| |8|  2 3|
+ + + +-+ + + +-+ + +
| |  8 9 0|  9 0 1|7|
+-+-+-+-+-+-+-+-+-+ +

+ +-+-+-+-+-+-+-+-+-+
|# # #|# # # #|     |
+-+-+ + +-+-+ +-+-+ +
|# # #|# #| |#|# #| |
+ +-+-+ + + + + + + +
|# #|   |#| |# #|#| |
+-+ +-+-+ + +-+-+ + +
| |# #|# #|# #  |# #|
+ +-+ + +-+ + +-+-+ +
|   |# #| |#|# #|# #|
+ + +-+-+ + +-+ + +-+
| | |# # # #| |#|#| |
+ + + +-+-+-+ + + + +
| | |#|  # # #|#|#| |
+ +-+ + + +-+ + + + +
|   |#| |#| |#|# #| |
+ + + + + + + +-+-+ +
| | |#| |#| |#|  # #|
+ + + +-+ + + +-+ + +
| |  # # #|  # # #|#|
+-+-+-+-+-+-+-+-+-+ +
Path: (0,0) (0,1) (0,2) (1,2) (1,1) (1,0) (2,0) (2,1) (3,1) (3,2) (4,2) (4,3) (3,3) (3,4) (2,4) (1,4) (1,3) (0,3) (0,4) (0,5) (0,6) (1,6) (2,6) (2,7) (1,7) (1,8) (2,8) (3,8) (3,9) (4,9) (4,8) (5,8) (6,8) (7,8) (7,7) (6,7) (5,7) (4,7) (4,6) (3,6) (3,5) (4,5) (5,5) (5,4) (5,3) (5,2) (6,2) (7,2) (8,2) (9,2) (9,3) (9,4) (8,4) (7,4) (6,4) (6,5) (6,6) (7,6) (8,6) (9,6) (9,7) (9,8) (8,8) (8,9) (9,9) 
Length of path: 65
Visited cells: 78

